EHHAAAAAAAAAAAAAAAAAAAAAAAAAAAAAAAAAAAAAAAAAAAAAAAABAAAAAAAAAAAAAAAAAAAAAAAAAAAAAAAAAAAAAAAAAAE   HA
RBB                                 BBB                                       BB              H A RA
AAA     ABM                                                         B  B            B              A
A                                                                         B   B      B             A
B                      MMMMMMMMMM G                                   BB           BB   B  R       B
A               C    M   MMMMMMG   MMMM                                                            A
           CCC     C  C CBBB MM MM   MG   M                                       A                A
ABB                  MMMMMMMM                    BBBBBB             BBBBB A B   BB                 A
A                           G           AA AA  BB BBB             AAA     B        AAAAAAAAAAAAAAAAA
B                        E  E           B BB BBBBBB BB             L     E         AAAAAAAAAAAAAAAAA
A        BBB       E    E                       HAAAA                              B   BBB         A
A                                               BBBBBBB B B          L             B       BBB     B
B                                                                                  BBBBB           A
         A                        S             S                C            B B        BBB       A
A          A  A               B     B  B                   RG M   M            B  BBB              A
               M               B  B     BB                    M GR MM    M            A     B      B
B   E   A M H                    BBBB   B                        MG   M                  AA B      A
B        A   G                B    B  BR             E            M  M                  BBB        A
A            BB   GR                                                  RG  C             B       AA A
      M  MBA    CB             B BH            BBBB  R  E    BBB                            A      A
A        G     G                B                    BB     E                      B  AA           A
                            B           S           BBBBB     BB                      B   B AA     B
B      L                                                  BH                            A          B
                         A     A                      RBBBRER                         B   B  AA    A
E        AAAR            A E   A         BB                H    A    A                       A     A
   S    AA           B   AAA   E AA    B                      A A AA    A                          A
@  L SBBB  BB    BBBB      HAAA   A     BBR    BB            A  R  BA B  AAB                       A
 H       AAA           BB     A   A                        A A  B  B B   B                         B
B                  BBBB     AAA   AAAH  BB                     BBB B     B                         A
A           R          BB    A MMMMM  A       BBB                       A                          A
                            HAAAAAAAAA   B                               A                        BB
A              B    B     B           B                                                          MEA